mmmmmmmmmmmm
m.p........m
m..........m
m..........m
m..........m
m..........m
m.......t..m
m..........m
m..........m
m..........m
m..........m
mmmmmmmmmmmm
